11111111111
1000P000001
1C000000001
100001100E1
11111111111
