1111111111111111111111111111111111
1000000000000000000000000000000001
1010010100100000101001000000010101
101001001011010000100100E000010101
100000000C000000000000000000000001
1000000000001110000100000000000001
1001110000000000000100000000000001
1000000000000111000100000000000001
100000000C0000000000000000000P0001
1111111111111111111111111111111111
