1111111111
10PCE00001
1111111111
